0;0;0;0;0;0;0;0;0;0;0;0;0;0;0;0;0;0;0;0;0;0;0;0;0;0;0;0
0;0;0;0;0;0;0;0;0;0;0;0;0;0;0;0;0;0;0;0;0;0;0;0;0;0;0;0
0;0;0;0;0;0;0;0;0;0;0;0;0;0;0;0;0;0;0;0;0;0;0;0;0;0;0;0
1;1;1;1;1;1;1;1;1;1;1;1;1;1;1;1;1;1;1;1;1;1;1;1;1;1;1;1
1;2;2;2;2;2;2;2;2;2;2;2;2;1;1;2;2;2;2;2;2;2;2;2;2;2;2;1
1;2;1;1;1;1;2;1;1;1;1;1;2;1;1;2;1;1;1;1;1;2;1;1;1;1;2;1
1;2;1;0;0;1;2;1;0;0;0;1;2;1;1;2;1;0;0;0;1;2;1;0;0;1;2;1
1;2;1;1;1;1;2;1;1;1;1;1;2;1;1;2;1;1;1;1;1;2;1;1;1;1;2;1
1;2;2;2;2;2;2;2;2;2;2;2;2;2;2;2;2;2;2;2;2;2;2;2;2;2;2;1
1;2;1;1;1;1;2;1;1;2;1;1;1;1;1;1;1;1;2;1;1;2;1;1;1;1;2;1
1;2;1;1;1;1;2;1;1;2;1;1;1;1;1;1;1;1;2;1;1;2;1;1;1;1;2;1
1;2;2;2;2;2;2;1;1;2;2;2;2;1;1;2;2;2;2;1;1;2;2;2;2;2;2;1
1;1;1;1;1;1;2;1;1;1;1;1;6;1;1;6;1;1;1;1;1;2;1;1;1;1;1;1
0;0;0;0;0;1;2;1;1;1;1;1;6;1;1;6;1;1;1;1;1;2;1;0;0;0;0;0
0;0;0;0;0;1;2;1;1;6;6;6;6;6;6;6;6;6;6;1;1;2;1;0;0;0;0;0
0;0;0;0;0;1;2;1;1;6;4;4;4;3;3;4;4;4;6;1;1;2;1;0;0;0;0;0
1;1;1;1;1;1;2;1;1;6;4;3;3;3;3;3;3;4;6;1;1;2;1;1;1;1;1;1
5;6;6;6;6;6;2;6;6;6;4;3;3;3;3;3;3;4;6;6;6;2;6;6;6;6;6;5
1;1;1;1;1;1;2;1;1;6;4;3;3;3;3;3;3;4;6;1;1;2;1;1;1;1;1;1
0;0;0;0;0;1;2;1;1;6;4;4;4;4;4;4;4;4;6;1;1;2;1;0;0;0;0;0
0;0;0;0;0;1;2;1;1;6;6;6;6;6;6;6;6;6;6;1;1;2;1;0;0;0;0;0
0;0;0;0;0;1;2;1;1;6;1;1;1;1;1;1;1;1;6;1;1;2;1;0;0;0;0;0
1;1;1;1;1;1;2;1;1;6;1;1;1;1;1;1;1;1;6;1;1;2;1;1;1;1;1;1
1;2;2;2;2;2;2;2;2;2;2;2;2;1;1;2;2;2;2;2;2;2;2;2;2;2;2;1
1;2;1;1;1;1;2;1;1;1;1;1;2;1;1;2;1;1;1;1;1;2;1;1;1;1;2;1
1;2;1;1;1;1;2;1;1;1;1;1;2;1;1;2;1;1;1;1;1;2;1;1;1;1;2;1
1;2;2;2;1;1;2;2;2;2;2;2;2;7;7;2;2;2;2;2;2;2;1;1;2;2;2;1
1;1;1;2;1;1;2;1;1;2;1;1;1;1;1;1;1;1;2;1;1;2;1;1;2;1;1;1
1;1;1;2;1;1;2;1;1;2;1;1;1;1;1;1;1;1;2;1;1;2;1;1;2;1;1;1
1;2;2;2;2;2;2;1;1;2;2;2;2;1;1;2;2;2;2;1;1;2;2;2;2;2;2;1
1;2;1;1;1;1;1;1;1;1;1;1;2;1;1;2;1;1;1;1;1;1;1;1;1;1;2;1
1;2;1;1;1;1;1;1;1;1;1;1;2;1;1;2;1;1;1;1;1;1;1;1;1;1;2;1
1;2;2;2;2;2;2;2;2;2;2;2;2;2;2;2;2;2;2;2;2;2;2;2;2;2;2;1
1;1;1;1;1;1;1;1;1;1;1;1;1;1;1;1;1;1;1;1;1;1;1;1;1;1;1;1
0;0;0;0;0;0;0;0;0;0;0;0;0;0;0;0;0;0;0;0;0;0;0;0;0;0;0;0
0;0;0;0;0;0;0;0;0;0;0;0;0;0;0;0;0;0;0;0;0;0;0;0;0;0;0;0
